################################
#....##......##.......##......K#
#.##..###.##.##..###......##...#
#..................#....#...#..#
#.####.##...##.##.##...##.####.#
#......##......##......##......#
###.####.##...#####.####.##.##.#
#......##..............##......#
#.####.##.####....####.##.####.#
#............#....#.D.#...##.#.#
#.##.####.##.####.##.####.##.###
#......##......##...|.K##......#
###..###....####.##.####.##.##.#
#......##......##......##......#
#.####.##.####.##.####.##.####.#
#....#......K#...##...#...#D.|.#
#.####.##.####.##.####.##.####.#
#......##......##......##......|
#...#...##...#...##...#.......##
################################
~K(1,30) = D(11,20)
~K(11,22) = D(17,31)
~K(15,12) = D(15,29)
~T(15,27) = (1 = 500, 1 = 50)
~T(9,20) = (1 = 450)