################################################################
#......####..........####..............####..........####....K##
#......####..........####..............####..........####.....##
##..##......####.####......####..####..####......####......##..#
##..##......####.####......####..####..####......####......##..#
#..........................................##........##....##..#
#..........................................##........##....##..#
#######.####....####..####..####....####..####..####....####.###
#######|#####...####..####..####....####..####..####....####.###
#............##..........##..........##..........##..........###
#............##.........K##..........##..........##..........###
####...########...#####.####.....##.########.######..######.##.#
####...########...#####.####.....##.########.######..######.##.#
#............##......................##........................#
#............##......................##............##..........#
#..####..##############..####....###|.D###..###..####..####...##
#..####..##############..####....###|.K###..###..####..####...##
#............##..........#...........##............##..........#
#K...........##..........#...........##............##..........#
####.##########.##########..####....####..##########.########..#
####|##########.##########..####....####..##########.########..#
#D...#.............##.................##...................##..#
#....|.............###................##...................##..#
########..######..##D.####..######..##..####..######..####.....#
########..######..###|####..######..##..####..######..####.....#
#..........................................##.........#........#
#..........................................##.........#........|
#..####..######..######..####....####..######..############....#
#K.####..######..######..####...K####..######..############...K#
################################################################
~K(1,61) = D(20,4)
~K(10,24) = D(8,7)
~K(16,38) = D(15,36)
~K(18,1) = D(16,36)
~K(28,1) = D(24,21)
~K(28,32) = D(26,63)
~K(28,62) = D(22,5)
~T(21,1) = (1 = 500)
~T(23,20) = (1 = 450)
~T(15,38) = (1 = 500)
